F 76,76,76
C 99,99,99

NO textures/simonkraft/cobblestone.xpm
SO textures/simonkraft/cobblestone_01.xpm
WE textures/simonkraft/mossy_cobblestone1.xpm
EA textures/simonkraft/cobblestone_02.xpm

1111111111111111111
1001001001001000001
1011000001000001001
1001001001111101111
1001111000001001001
1000000000000001001
1001111111111001001
1111000000000001011
1000000001000000001
1111111111111111111

