NO textures/wolfenstein/purple_stone.xpm
EA textures/wolfenstein/purple_stone.xpm
SO textures/wolfenstein/grey_stone.xpm
WE textures/wolfenstein/grey_stone.xpm

F      17,    38,     64
C      17,    38,     64


1111111111111111111111111
1000110000100000000000001
1000110000000000N11111001
1000110000000000110001001
1000000000100000000001001
1111111111111111111111111
